Muni_ID,ID,Muni,slurry,solid,storage_N,storage_nha
1601,1111601,Arcos de Valdevez,351,14299,14650,0.792816951
1602,1111602,Caminha,407,8758,9165,2.783920191
1603,1111603,Melgaço,215,4698,4913,0.310775725
1604,1111604,Monção,392,9241,9633,1.41635972
1605,1111605,Paredes de Coura,1621,12157,13778,3.488947297
1606,1111606,Ponte da Barca,469,12908,13377,3.49258112
1607,1111607,Ponte de Lima,6704,34453,41157,4.65471574
1608,1111608,Valença,1171,5056,6227,2.256864634
1609,1111609,Viana do Castelo,4960,24931,29891,4.226007146
1610,1111610,Vila Nova de Cerveira,956,2753,3709,2.701696788
301,1120301,Amares,5594,18075,23669,12.27656136
302,1120302,Barcelos,73456,107468,180924,16.47010071
303,1120303,Braga,7148,19871,27019,7.324218625
306,1120306,Esposende,9586,16991,26577,12.61986409
310,1120310,Terras de Bouro,206,7260,7466,1.10023199
313,1120313,Vila Verde,4198,19502,23700,4.64347828
307,1130307,Fafe,962,34303,35265,11.65800003
308,1130308,Guimarães,5727,28018,33745,7.85141409
309,1130309,Póvoa de Lanhoso,1955,6649,8604,4.23235288
1314,1131314,Santo Tirso,5192,8471,13663,6.284847798
1318,1131318,Trofa,10335,25627,35962,22.46250259
311,1130311,Vieira do Minho,571,6662,7233,1.22226733
312,1130312,Vila Nova de Famalicão,32365,37557,69922,13.12588171
314,1130314,Vizela,358,968,1326,3.134139525
107,1140107,Espinho,441,632,1073,15.33443935
1304,1141304,Gondomar,471,3713,4184,3.449020517
1306,1141306,Maia,8273,13243,21516,12.5167281
1308,1141308,Matosinhos,6974,8804,15778,13.75550131
1312,1141312,Porto,2,76,78,1.907489518
1313,1141313,Póvoa de Varzim,33114,36207,69321,20.84200929
1315,1141315,Valongo,1736,45118,46854,71.31581975
1316,1141316,Vila do Conde,63530,70472,134002,21.98924112
1317,1141317,Vila Nova de Gaia,555,2465,3020,3.203007464
1301,1151301,Amarante,1273,8234,9507,1.086819118
1302,1151302,Baião,507,5153,5660,1.166936814
304,1150304,Cabeceiras de Basto,695,11949,12644,2.258721508
106,1150106,Castelo de Paiva,375,3696,4071,3.024263784
305,1150305,Celorico de Basto,1332,8084,9416,2.914381441
1804,1151804,Cinfães,407,5217,5624,1.262303976
1303,1151303,Felgueiras,6112,10118,16230,5.569589753
1305,1151305,Lousada,1662,6311,7973,3.333342912
1307,1151307,Marco de Canaveses,447,4217,4664,1.450561471
1705,1151705,Mondim de Basto,275,3165,3440,0.643655879
1309,1151309,Paços de Ferreira,1935,4797,6732,6.542344991
1310,1151310,Paredes,1460,7086,8546,4.283887391
1311,1151311,Penafiel,2623,7280,9903,3.016358983
1813,1151813,Resende,504,2800,3304,0.969870698
1709,1151709,Ribeira de Pena,864,5277,6141,0.837207063
104,1160104,Arouca,6272,11746,18018,4.042720928
113,1160113,Oliveira de Azeméis,12582,17401,29983,18.70408021
109,1160109,Santa Maria da Feira,4507,6174,10681,8.613702173
116,1160116,São João da Madeira,0,69,69,0
119,1160119,Vale de Cambra,1417,7395,8812,4.707408379
1701,1171701,Alijó,173,2589,2762,0.320136335
1801,1171801,Armamar,124,890,1014,0.223546503
403,1170403,Carrazeda de Ansiães,353,2320,2673,0.393402167
404,1170404,Freixo de Espada à Cinta,64,1064,1128,0.156801644
1805,1171805,Lamego,226,2067,2293,0.424959376
1704,1171704,Mesão Frio,14,166,180,0.16760038
1807,1171807,Moimenta da Beira,4508,11440,15948,3.77282425
1812,1171812,Penedono,606,2797,3403,0.984373907
1708,1171708,Peso da Régua,41,889,930,0.221518713
1710,1171710,Sabrosa,619,20262,20881,4.108089255
1711,1171711,Santa Marta de Penaguião,18,652,670,0.187102317
1815,1171815,São João da Pesqueira,70,1044,1114,0.084988313
1818,1171818,Sernancelhe,1059,13963,15022,2.958868273
1819,1171819,Tabuaço,58,1060,1118,0.273287725
1820,1171820,Tarouca,903,8083,8986,4.772046293
409,1170409,Torre de Moncorvo,119,11560,11679,0.816018926
410,1170410,Vila Flor,125,1905,2030,0.21908853
914,1170914,Vila Nova de Foz Côa,16,814,830,0.065422331
1714,1171714,Vila Real,1546,18767,20313,1.920663612
401,1180401,Alfândega da Fé,188,2246,2434,0.206926087
1702,1181702,Boticas,834,15767,16601,1.198895726
402,1180402,Bragança,2191,14371,16562,0.459670123
1703,1181703,Chaves,9325,47155,56480,2.899400455
405,1180405,Macedo de Cavaleiros,1163,21183,22346,1.024920824
406,1180406,Miranda do Douro,2758,12000,14758,0.676555745
407,1180407,Mirandela,1826,24082,25908,1.043255879
408,1180408,Mogadouro,11022,22702,33724,1.02827366
1706,1181706,Montalegre,2394,18735,21129,0.383708109
1707,1181707,Murça,425,2223,2648,0.557158188
1712,1181712,Valpaços,1821,12040,13861,0.631138612
1713,1181713,Vila Pouca de Aguiar,4279,17976,22255,1.928818309
411,1180411,Vimioso,613,6610,7223,0.497917432
412,1180412,Vinhais,2362,10091,12453,0.711140318
101,1610101,Águeda,3711,22323,26034,13.6805315
102,1610102,Albergaria-a-Velha,4196,36852,41048,19.5188157
103,1610103,Anadia,2698,16276,18974,5.506191906
105,1610105,Aveiro,2589,4918,7507,3.097001782
108,1610108,Estarreja,9954,15036,24990,7.875838517
110,1610110,Ílhavo,687,13651,14338,17.44229252
111,1610111,Mealhada,2656,13765,16421,9.614040495
112,1610112,Murtosa,5681,8084,13765,9.578979326
114,1610114,Oliveira do Bairro,2510,4163,6673,3.750892751
115,1610115,Ovar,7234,23615,30849,18.43913501
117,1610117,Sever do Vouga,1118,30470,31588,48.74639047
118,1610118,Vagos,5071,10387,15458,6.155971136
602,1620602,Cantanhede,11479,21062,32541,5.634734471
603,1620603,Coimbra,2049,7673,9722,1.87252394
604,1620604,Condeixa-a-Nova,387,1663,2050,1.076910856
605,1620605,Figueira da Foz,8608,15035,23643,4.291775261
608,1620608,Mira,6611,9805,16416,15.32783275
610,1620610,Montemor-o-Velho,14150,16702,30852,3.652432402
613,1620613,Penacova,353,2265,2618,3.301556324
615,1620615,Soure,990,76751,77741,15.8719428
1004,1631004,Batalha,8339,8168,16507,16.70755286
1009,1631009,Leiria,122049,76386,198435,40.74647837
1010,1631010,Marinha Grande,56,419,475,3.085337258
1015,1631015,Pombal,15176,35909,51085,12.4353971
1016,1631016,Porto de Mós,59354,8618,67972,20.2902937
1002,1641002,Alvaiázere,295,6519,6814,4.75504186
1003,1641003,Ansião,2008,11439,13447,5.626159022
601,1640601,Arganil,224,3579,3803,2.724559269
1007,1641007,Castanheira de Pêra,31,247,278,3.089725377
1008,1641008,Figueiró dos Vinhos,147,905,1052,2.754307673
606,1640606,Góis,2070,350,2420,14.23773447
607,1640607,Lousã,181,5158,5339,13.0230912
609,1640609,Miranda do Corvo,198,1085,1283,1.857431937
611,1640611,Oliveira do Hospital,185,69639,69824,23.48603056
612,1640612,Pampilhosa da Serra,45,994,1039,2.349958056
1013,1641013,Pedrógão Grande,96,725,821,1.682488909
614,1640614,Penela,216,1363,1579,1.395982044
616,1640616,Tábua,536,2964,3500,1.639437981
617,1640617,Vila Nova de Poiares,108,578,686,2.629373084
901,1650901,Aguiar da Beira,3428,26890,30318,10.1093075
1802,1651802,Carregal do Sal,1002,9937,10939,7.763432987
1803,1651803,Castro Daire,1204,19904,21108,6.844251472
1806,1651806,Mangualde,558,8455,9013,2.399008474
1808,1651808,Mortágua,822,25853,26675,31.19921397
1809,1651809,Nelas,288,12059,12347,4.458842992
1810,1651810,Oliveira de Frades,1757,75957,77714,52.19187853
1811,1651811,Penalva do Castelo,247,4031,4278,1.658164406
1814,1651814,Santa Comba Dão,3832,20986,24818,20.14416403
1816,1651816,São Pedro do Sul,1821,54472,56293,14.86866057
1817,1651817,Sátão,1478,32106,33584,12.16363545
1821,1651821,Tondela,1757,64045,65802,15.70069274
1822,1651822,Vila Nova de Paiva,872,26166,27038,16.87795513
1823,1651823,Viseu,1209,23520,24729,4.243857579
1824,1651824,Vouzela,1523,48201,49724,24.6400586
1413,1661413,Mação,624,2181,2805,1.733743951
506,1660506,Oleiros,262,8035,8297,6.954882549
508,1660508,Proença-a-Nova,439,3751,4190,1.021841656
509,1660509,Sertã,5899,6536,12435,5.048623546
510,1660510,Vila de Rei,457,1353,1810,5.323021195
905,1670905,Fornos de Algodres,244,3863,4107,1.449776479
906,1670906,Gouveia,245,6758,7003,1.053383512
912,1670912,Seia,184,4755,4939,0.908971472
902,1680902,Almeida,5478,6332,11810,0.596320637
903,1680903,Celorico da Beira,490,3148,3638,0.436899193
904,1680904,Figueira de Castelo Rodrigo,793,4850,5643,0.236474379
907,1680907,Guarda,2596,11554,14150,0.735126802
908,1680908,Manteigas,51,417,468,1.625305373
909,1680909,Mêda,127,4433,4560,0.492782683
910,1680910,Pinhel,1434,9650,11084,0.586726099
911,1680911,Sabugal,865,7754,8619,0.431066179
913,1680913,Trancoso,1532,6842,8374,0.752725608
502,1690502,Castelo Branco,2392,11676,14068,0.333302263
505,1690505,Idanha-a-Nova,3944,20374,24318,0.303384811
507,1690507,Penamacor,1219,3869,5088,0.42098673
511,1690511,Vila Velha de Ródão,403,2141,2544,0.450628558
501,16A0501,Belmonte,539,2290,2829,0.572031495
503,16A0503,Covilhã,2747,7266,10013,0.927847639
504,16A0504,Fundão,5274,10606,15880,0.616148856
1001,16B1001,Alcobaça,82318,15229,97547,13.31335054
1101,16B1101,Alenquer,1582,29696,31278,2.860363919
1102,16B1102,Arruda dos Vinhos,3423,5250,8673,3.0797606
1005,16B1005,Bombarral,474,35263,35737,8.432585795
1104,16B1104,Cadaval,13058,7436,20494,4.105301856
1006,16B1006,Caldas da Rainha,16851,34282,51133,11.00811745
1108,16B1108,Lourinhã,51714,82236,133950,23.75419403
1011,16B1011,Nazaré,4387,1275,5662,6.016991322
1012,16B1012,Óbidos,196,41311,41507,13.28220109
1014,16B1014,Peniche,1584,11476,13060,5.363317363
1112,16B1112,Sobral de Monte Agraço,5694,5728,11422,4.428901481
1113,16B1113,Torres Vedras,31480,99651,131131,9.023005929
1401,16C1401,Abrantes,1691,5368,7059,0.546578687
1402,16C1402,Alcanena,1115,3991,5106,1.164873401
1408,16C1408,Constância,0,87,87,0.156210748
1410,16C1410,Entroncamento,0,129,129,0.251532767
1411,16C1411,Ferreira do Zêzere,15815,71142,86957,38.42546467
1421,16C1421,Ourém,859,79002,79861,18.46066455
1417,16C1417,Sardoal,61,789,850,0.652473097
1418,16C1418,Tomar,7091,41549,48640,7.186825261
1419,16C1419,Torres Novas,4992,9790,14782,1.493756505
1420,16C1420,Vila Nova da Barquinha,2,126,128,0.30897091
1115,1711115,Amadora,0,15,15,0.252232136
1105,1711105,Cascais,9,84,93,0.393231352
1106,1711106,Lisboa,2,3,5,0.085789366
1107,1711107,Loures,1843,11866,13709,3.198655901
1109,1711109,Mafra,7475,41262,48737,5.248485794
1116,1711116,Odivelas,29,554,583,1.22748977
1110,1711110,Oeiras,0,4,4,0.036216666
1111,1711111,Sintra,1377,7194,8571,1.665296156
1114,1711114,Vila Franca de Xira,2096,7384,9480,0.705793343
1502,1721502,Alcochete,3102,1593,4695,1.390980252
1503,1721503,Almada,63,665,728,1.718074956
1504,1721504,Barreiro,11,349,360,2.167596429
1506,1721506,Moita,3506,4358,7864,8.474404546
1507,1721507,Montijo,69393,8154,77547,5.17569136
1508,1721508,Palmela,22986,35006,57992,1.986765908
1510,1721510,Seixal,10,141,151,0.221754863
1511,1721511,Sesimbra,40,713,753,0.405545158
1512,1721512,Setúbal,42,1912,1954,0.673272368
1501,1811501,Alcácer do Sal,5595,14738,20333,0.209729862
1505,1811505,Grândola,34722,7671,42393,1.110528509
211,1810211,Odemira,11442,20899,32341,0.4627221
1509,1811509,Santiago do Cacém,23888,13752,37640,0.609310483
1513,1811513,Sines,337,2354,2691,0.302271361
1201,1821201,Alter do Chão,1418,9715,11133,0.334793199
1202,1821202,Arronches,2500,5928,8428,0.326178116
1203,1821203,Avis,3507,8953,12460,0.267636327
1204,1821204,Campo Maior,2406,4519,6925,0.376567445
1205,1821205,Castelo de Vide,31,3002,3033,0.149835623
1206,1821206,Crato,3823,6615,10438,0.391702601
1207,1821207,Elvas,1929,24714,26643,0.513658194
1208,1821208,Fronteira,891,4761,5652,0.263040085
1209,1821209,Gavião,42,1221,1263,0.088743709
1210,1821210,Marvão,23,1354,1377,0.16007447
1211,1821211,Monforte,586,10606,11192,0.290690683
707,1820707,Mora,981,7202,8183,0.19968533
1212,1821212,Nisa,447,5415,5862,0.209907545
1213,1821213,Ponte de Sor,5728,8637,14365,0.255342057
1214,1821214,Portalegre,1934,8155,10089,0.365477315
701,1830701,Alandroal,5663,10880,16543,0.377749501
702,1830702,Arraiolos,31141,14558,45699,0.787531935
703,1830703,Borba,2436,3229,5665,0.666262739
704,1830704,Estremoz,6494,7561,14055,0.367530859
705,1830705,Évora,5867,25484,31351,0.293505745
706,1830706,Montemor-o-Novo,60494,28640,89134,0.838121253
708,1830708,Mourão,1847,5191,7038,0.329210461
709,1830709,Portel,28317,10645,38962,0.946612052
710,1830710,Redondo,5831,9601,15432,0.508474739
711,1830711,Reguengos de Monsaraz,2151,5077,7228,0.248595767
1215,1831215,Sousel,2625,4572,7197,0.348519017
712,1830712,Vendas Novas,21161,17142,38303,2.44654227
713,1830713,Viana do Alentejo,9090,10336,19426,0.488279774
714,1830714,Vila Viçosa,544,4624,5168,0.32730072
201,1840201,Aljustrel,2618,7052,9670,0.248411036
202,1840202,Almodôvar,3121,6816,9937,0.254482181
203,1840203,Alvito,675,7261,7936,0.345552388
204,1840204,Barrancos,2910,2204,5114,0.401837811
205,1840205,Beja,5097,10692,15789,0.16294366
206,1840206,Castro Verde,1518,7418,8936,0.176127136
207,1840207,Cuba,12133,4037,16170,1.110749506
208,1840208,Ferreira do Alentejo,10588,7952,18540,0.342815222
209,1840209,Mértola,4511,12508,17019,0.189065401
210,1840210,Moura,5140,12111,17251,0.236242789
212,1840212,Ourique,19270,7630,26900,0.605988119
213,1840213,Serpa,4434,16396,20830,0.240682108
214,1840214,Vidigueira,382,2567,2949,0.128586153
1403,1851403,Almeirim,53,2424,2477,0.25688377
1404,1851404,Alpiarça,70,382,452,0.091700481
1103,1851103,Azambuja,11800,10556,22356,2.007930818
1405,1851405,Benavente,57172,24816,81988,2.847585297
1406,1851406,Cartaxo,72543,7159,79702,11.42188405
1407,1851407,Chamusca,2947,8324,11271,0.34959476
1409,1851409,Coruche,14182,16363,30545,0.547054202
1412,1851412,Golegã,121,509,630,0.10826124
1414,1851414,Rio Maior,32467,65493,97960,10.61783565
1415,1851415,Salvaterra de Magos,6860,7877,14737,1.795048439
1416,1851416,Santarém,45835,49142,94977,4.116388685
801,1500801,Albufeira,40,656,696,0.205104085
802,1500802,Alcoutim,199,1196,1395,0.112043406
803,1500803,Aljezur,202,1649,1851,0.444613591
804,1500804,Castro Marim,330,1944,2274,0.318654334
805,1500805,Faro,51,719,770,0.188787896
806,1500806,Lagoa,1390,426,1816,1.216641248
807,1500807,Lagos,135,1470,1605,0.685129801
808,1500808,Loulé,389,1924,2313,0.166536785
809,1500809,Monchique,5274,1363,6637,3.161997385
810,1500810,Olhão,41,355,396,0.156462313
811,1500811,Portimão,1101,1835,2936,1.207581586
812,1500812,São Brás de Alportel,48,338,386,0.125504334
813,1500813,Silves,2563,2765,5328,0.438766345
814,1500814,Tavira,399,1284,1683,0.152555959
815,1500815,Vila do Bispo,52,1338,1390,0.286874786
816,1500816,Vila Real de Santo António,44,322,366,0.305431108
